145 145 145 145 145 145 145 145 145 145 145 145 145 145 145 145 145 145 145 145 145 145 145 145 145 145 145 145 145 145
145 145 145 145 145 145 145 145 145 145 145 145 145 145 145 145 145 145 145 145 145 145 145 145 145 145 145 145 145 145
145 145 145 145 145 145 145 145 145 145 145 145 145 145 145 145 145 145 145 145 145 145 145 145 145 145 145 145 145 145
145 145 145 145 145 145 145 145 145 145 145 145 145 145 145 145 145 145 145 145 145 145 145 145 145 145 145 145 145 145
145 145 145 145 145 145 145 145 145 145 145 145 145 145 145 145 145 145 145 145 145 145 145 145 145 145 145 145 145 145
145 145 145 145 145 145 145 145 145 145 145 145 145 145 145 145 145 145 145 145 145 145 145 145 145 145 145 145 145 145
145 145 145 145 145 145 145 145 145 145 145 145 145 145 145 145 145 145 145 145 145 145 145 145 145 145 145 145 145 145
145 145 145 145 145 145 145 145 145 145 145 145 145 145 145 145 145 145 145 145 145 145 145 145 145 145 145 145 145 145
145 145 145 145 145 145 145 145 145 145 145 145 145 145 145 145 145 145 145 145 145 145 145 145 145 145 145 145 145 145
145 145 145 145 145 145 145 145 145 145 145 145 145 145 145 145 145 145 145 145 145 145 145 145 145 145 145 145 145 145
000 000 000 000 000 000 000 145 145 145 145 000 000 000 000 000 000 000 000 145 145 145 145 000 000 000 000 000 000 000
016 016 016 016 016 016 016 145 145 145 145 016 016 016 016 016 016 016 016 145 145 145 145 016 016 016 016 016 016 016
001 001 001 001 001 001 001 148 148 148 148 001 001 001 001 001 001 001 001 148 148 148 148 001 001 001 001 001 001 001
001 001 001 001 001 001 001 164 164 164 164 001 001 001 001 001 001 001 001 164 164 164 164 001 001 001 001 001 001 001
001 001 001 001 001 001 001 164 164 164 164 001 001 001 001 001 001 001 001 164 164 164 164 001 001 001 001 001 001 001