145 145 145 145 145 145 145 145 145 145 145 145 145 145 145 145 145 145 145 145 145 145 145 145 145 145 145 145 145 145
145 145 145 145 145 145 145 145 145 145 145 145 145 145 145 145 145 145 145 145 145 145 145 145 145 145 145 145 145 145
145 145 145 145 145 145 145 145 145 145 145 145 145 145 145 145 145 145 145 145 145 145 145 145 145 145 145 145 145 145
145 145 145 145 145 145 145 145 145 145 145 145 145 145 145 145 145 145 145 145 145 145 145 145 145 145 145 145 145 145
145 145 145 145 145 145 145 145 145 145 145 145 145 145 145 145 145 145 145 145 145 145 145 145 145 145 145 145 145 145
145 145 145 145 145 145 145 145 145 145 145 145 145 145 145 145 145 145 145 145 145 145 145 145 145 145 145 145 145 145
145 145 145 145 145 145 145 145 145 145 145 145 145 145 145 145 145 145 145 145 145 145 145 145 145 145 050 050 050 050
145 145 145 145 145 145 145 145 145 145 145 145 145 145 145 145 145 145 145 145 145 145 145 145 145 145 145 145 145 145
145 145 145 145 145 145 145 145 145 145 145 145 145 145 145 145 145 145 145 145 145 145 145 145 145 145 145 145 145 145
145 145 145 145 145 145 145 145 008 145 145 145 145 145 145 145 145 145 145 145 145 145 145 145 145 145 145 145 145 145
000 000 000 000 000 145 145 145 008 145 145 145 000 000 000 000 000 000 145 145 145 145 145 000 000 000 000 000 000 000
016 016 016 016 016 145 145 145 008 145 145 145 016 016 016 016 016 016 145 145 145 145 145 016 016 016 016 016 016 016
001 001 001 001 001 145 145 145 008 145 145 145 001 001 001 001 001 001 145 145 008 145 145 001 001 001 001 001 001 001
001 001 001 001 001 148 148 148 008 148 148 148 001 001 001 001 001 001 148 148 008 148 148 001 001 001 001 001 001 001
008 008 008 008 008 164 164 164 008 164 164 164 008 008 008 008 008 008 164 164 008 164 164 008 008 008 008 008 008 008